1111111111
1000E00001
1000000001
100000P001
1000000001
1000010001
1000001001
100000C001
10000C0001
1000100001
1000110001
1000000001
1111111111

