111111111111111111111111111111111111
100010000000000000000C00010000000001
100010000000000000000C01010000000001
100010000000000000000C01010000000001
1000100000000000C0000C01010000000001
1000100000000P0000000C01010000000001
100010000000000000000C01010E00000001
100010000000000000000C01010000000001
100010000000000000000C01010000000001
100010000000C0000C000C01010000000001
1000000111C1000000000C01010000000001
100000000000000000000C0100000000P001
111111111111111111111111111111111111

