1111111111
100000C001
10000P0001
1000C01001
100C001001
10M0000001
1001C10M01
1000E1C001
10M0000001
100C000001
1111111111

