1111111111111111111
1000100000000000001
1000100000000000001
1000100000000000001
1000100M0000M000001
1000100000000P00001
100010000000000E001
1000100M00000000001
1000100000000000001
100010000000C000001
1000000111C10000001
1000000000000000001
1111111111111111111
