1111111111
1M00000001
1000100001
1001M11001
1001C11001
1001E10001
1001P10001
100M010001
1000000001
1010000001
1111111111






