1111111111
1M00E00001
10000P0001
1000C00M01
10000M0001
1111111111

