111111111111111111111111111111111111111111111111111111111111111111111111111111111111111111111111
111111111111111111111111111111111111111111111111111111111111111111111111111111111111111111111111
111111111111111111000000000000111100000000000011111111111111111111111111111111111111111111111111
111111111111111111000000100000111101110000111011111111111111111111111111111111111111111111111111
111111111111111111000001010000111101000000001011111111111111111111111111111111111111111111111111
111111111111111111000010001000000001011111101011111111111111111111111111111111111111111111111111
111111111111111111000001010000111101000000001011111111111111111111111111111111111111111111111111
111111111111111111000000100000111101110000111011111111111111111111111111111111111111111111111111
111111111111111111000000000000111100000000000011111111111111111111111111111111111111111111111111
111111111111111111111111111111111111111001111111111111111111111111111111111111111111111111111111
111111111111111111111111111111111111111001111111111111111111111111111111111111111111111111111111
111111111111111111111111111111111111111001111111111111111111111111111111111111111111111111111111
111111111111111111111111111111111111111001111111111111111111111111111111111111111111111111111111
111111111111111111111111111111111111111001111111111111111111111111000000011111111100000000000011
111111111111111111111111111111111110001000010111111111111111111111000000000111111101111111111011
111111111111111111111111111111111110101011010111111111111111111111000000000011111101001001001011
1111111111111111111111111111111111001010010100111111111111111111110000M00000000000010100C0101011
111111111111111111111111111111111110101101010111111111111111111111000000000011111101000000001011
1111111111111111111111111111111111101000M1000111111111111111111111000000000111111101111001111011
111111111111111111111111111111111111111001111111111111111111111111000000011111111100000000000011
111111111111111111111111111111111111111001111111111111111111111111111110011111111111111111111111
111111111111111111111111111111111111111001111111111111111111111111111110011111111111111111111111
111111111111111111111111111111111111111001111111111111111111111111111110011111111111111111111111
111111111111111111111111111111111111111001111111111111111111111111111110011111111111111111111111
110000000000001111000000000000111100000000000011110000000000001111000000000000111111111111111111
110000000000001111000000000000111101100000011011110000000000001111010101101010111111111111111111
110000000000001111000000000000111100000000000011110010000001001111000000000000111111111111111111
110000000000000000000M01000000000000000110000000000000000000000000010101101010111111111111111111
110000000000001111000000000000111100000000000011110010000001001111000000000000111111111111111111
110000000000001111000000000000111101100000011011110000000000001111010101101010111111111111111111
110000000000001111000000000000111100000000000011110000000000001111000000000000111111111111111111
111111111111111111111110011111111111111001111111111111100111111111111111111111111111111111111111
111111111111111111111110011111111111111001111111111111100111111111111111111111111111111111111111
111111111111111111111110011111111111111001111111111111100111111111111111111111111111111111111111
111111111111111111111110011111111111111001111111111111100111111111111111111111111111111111111111
111111111111111111000000000000111100000000000011110000000000001111111111111111111111111111111111
111111111111111111000000000000111100000000000011110010000001001111111111111111111111111111111111
111111111111111111000001100000111100100000010011110000000000001111111111111111111111111111111111
11111111111111111100M0011000000000000000C0000000000000000000001111111111111111111111111111111111
111111111111111111000001100000111100100000010011110000000000001111111111111111111111111111111111
111111111111111111000000000000111100000000000011110010000001001111111111111111111111111111111111
111111111111111111000000000000111100000000000011110000000000001111111111111111111111111111111111
111111111111111111111111111111111111111001111111111111111111111111111111111111111111111111111111
111111111111111111111111111111111111111001111111111111111111111111111111111111111111111111111111
111111111111111111111111111111111111111001111111111111111111111111111111111111111111111111111111
111111111111111111111111111111111111111001111111111111111111111111111111111111111111111111111111
111111111111111111111111111111111100000000000011111111111111111111111111111111111111111111111111
111111111111111111111111111111111100000000000011111111111111111111111111111111111111111111111111
111111111111111111111111111111111100000110000011111111111111111111111111111111111111111111111111
111111111111111111111111111111111100000110000011111111111111111111111111111111111111111111111111
111111111111111111111111111111111100000110000011111111111111111111111111111111111111111111111111
111111111111111111111111111111111100000000000011111111111111111111111111111111111111111111111111
111111111111111111111111111111111100000000000011111111111111111111111111111111111111111111111111
111111111111111111111111111111111111111001111111111111111111111111111111111111111111111111111111
111111111111111111111111111111111111111001111111111111111111111111111111111111111111111111111111
111111111111111111111111111111111111111001111111111111111111111111111111111111111111111111111111
111111111111111111111111111111111111111001111111111111111111111111111111111111111111111111111111
111111111111111111000000000000111100000000000011110000000000001111111111111111111111111111111111
111111111111111111000000000000111101001001001011110000000000001111111111111111111111111111111111
111111111111111111000000000000111100000000000011110011000011001111111111111111111111111111111111
111111111111111111000000E00M00000010010010010000000110000110011111111111111111111111111111111111
111111111111111111000000000C0011110P000000000011110011000011001111111111111111111111111111111111
111111111111111111000000000000111101001001001011110000000000001111111111111111111111111111111111
111111111111111111000000000000111100000000000011110000000000001111111111111111111111111111111111
111111111111111111111111111111111111111001111111111111111111111111111111111111111111111111111111
111111111111111111111111111111111111111N01111111111111111111111111111111111111111111111111111111
111111111111111111111111111111111111111111111111111111111111111111111111111111111111111111111111
